64
64
8 3 45 42 44 26 29 37 45 31 44 23 21 40 27 16 0 17 20 1 13 44 38 33 14 42 29 23 36 22 1 44 44 27 4 0 25 31 8 9 29 38 46 14 18 10 11 38 29 39 22 4 12 37 19 16 9 30 32 5 43 49 12 49 
36 6 42 46 41 31 18 29 44 31 20 16 37 47 16 16 28 49 44 3 21 6 33 20 47 19 3 20 43 29 20 42 28 34 33 15 47 41 0 18 8 15 38 31 37 45 24 16 39 23 20 27 29 2 21 1 24 25 0 13 24 48 12 11 
12 34 20 46 36 41 38 0 15 0 34 29 15 39 23 21 13 36 27 35 6 39 19 13 5 33 10 26 45 24 41 0 0 41 48 13 31 8 20 43 9 23 17 6 18 33 30 23 13 0 44 36 9 25 35 24 34 18 5 30 16 15 37 37 
32 35 27 0 11 22 7 36 44 5 26 20 15 16 1 22 7 31 36 10 30 36 40 27 29 40 47 38 46 41 24 0 27 24 5 45 33 31 43 13 38 49 45 19 47 46 16 19 44 9 3 40 48 0 17 18 30 42 27 22 19 30 23 0 
44 9 6 21 20 41 48 12 11 42 14 17 37 48 32 48 47 14 37 13 21 11 16 9 46 25 36 7 14 37 26 9 7 14 32 2 15 45 25 28 19 12 28 2 10 29 24 18 36 49 15 31 43 28 1 7 19 34 9 32 30 10 32 29 
31 5 45 18 42 49 49 5 18 46 32 22 49 33 38 33 0 8 14 27 21 35 29 38 8 16 30 29 24 27 3 21 2 18 40 12 22 25 46 15 25 49 31 33 5 32 20 29 17 20 15 2 37 42 18 30 21 41 49 11 49 16 9 47 
35 4 9 43 17 17 22 28 11 24 25 25 30 25 38 32 20 24 22 18 27 1 14 40 46 38 46 49 34 18 27 22 20 25 47 38 12 17 44 27 46 30 4 18 13 21 49 48 7 47 31 8 33 46 48 46 36 49 9 45 4 19 0 10 
30 32 3 46 33 44 39 6 15 38 39 42 14 16 28 8 45 46 38 39 25 30 3 22 43 6 36 38 10 17 20 9 39 14 15 49 1 12 28 17 46 27 15 9 35 37 33 38 16 1 30 1 10 9 31 41 8 9 30 17 47 34 3 10 
11 16 30 3 22 20 48 37 45 7 18 48 17 36 24 23 22 41 45 37 2 19 48 5 1 48 1 16 18 36 46 35 14 34 43 41 18 3 36 12 13 35 9 31 20 36 0 43 19 45 17 16 15 32 41 2 15 46 0 12 42 16 45 38 
32 33 34 36 28 0 44 44 8 26 8 34 2 15 2 46 13 40 44 28 44 22 44 38 2 31 34 6 35 27 8 49 5 33 37 37 24 34 36 16 35 32 15 12 12 30 6 27 34 29 43 34 4 23 9 0 22 10 15 3 32 23 8 28 
43 28 23 27 30 3 12 12 40 28 28 22 25 2 24 32 20 4 26 37 48 6 29 0 43 8 4 34 17 13 22 8 32 12 35 22 3 32 40 14 29 30 19 27 20 31 46 37 35 4 48 48 12 31 33 36 33 45 13 27 13 21 0 40 
32 49 3 15 32 7 20 13 40 36 46 3 40 7 1 44 2 38 1 45 29 28 21 41 16 8 34 6 22 44 42 7 28 38 25 33 43 34 40 33 39 32 12 19 4 27 38 6 43 13 28 45 16 1 25 3 22 43 5 48 19 34 36 5 
0 33 10 22 12 14 39 20 22 8 32 14 9 43 45 7 17 36 2 1 46 10 48 19 37 21 2 30 8 16 5 10 49 7 23 7 2 34 5 39 41 37 31 16 25 11 24 35 8 13 9 45 21 28 42 11 15 18 37 13 25 29 36 20 
25 17 29 33 39 44 14 4 33 49 5 0 31 39 14 7 35 11 36 48 3 31 16 47 31 8 5 22 43 30 35 49 17 0 10 6 25 47 21 11 18 13 22 15 41 21 16 33 40 37 49 6 17 45 15 9 40 30 5 29 2 28 39 47 
5 0 46 45 43 49 45 29 19 34 13 37 32 19 22 25 40 20 2 10 48 40 4 17 44 8 16 8 14 5 6 38 8 10 14 29 31 23 36 18 36 21 22 29 0 43 28 14 12 7 16 3 31 44 48 0 40 6 30 6 1 24 32 25 
7 34 43 30 12 39 48 16 32 7 2 48 18 26 22 4 22 18 36 38 39 20 16 26 6 33 39 40 13 9 28 44 8 24 2 19 44 44 9 23 49 22 46 8 42 34 49 19 9 12 31 46 45 40 25 36 41 22 0 1 29 16 16 23 
27 2 33 47 28 33 12 17 14 19 24 4 39 33 42 8 6 15 47 25 30 18 48 16 11 31 37 36 31 33 29 21 32 33 20 2 18 6 32 23 42 11 27 43 33 42 45 35 13 47 16 30 48 26 32 46 41 2 27 37 9 8 27 46 
25 37 9 33 3 1 17 8 19 49 33 24 19 42 36 22 10 36 28 32 45 40 11 27 13 31 11 17 8 16 24 16 8 21 9 11 44 39 17 36 20 18 45 23 38 11 11 39 19 12 17 41 16 1 40 25 13 27 11 29 33 9 31 32 
45 29 31 48 30 37 31 31 40 26 9 45 37 20 47 29 12 24 23 25 7 11 22 12 27 13 6 25 7 33 13 22 20 19 32 9 34 21 26 15 29 10 40 15 23 21 43 46 6 30 19 17 33 2 4 18 7 9 16 20 40 8 6 30 
31 14 35 31 39 22 8 14 49 23 37 47 45 21 35 34 24 19 21 11 28 34 16 20 49 25 3 31 41 48 32 11 13 16 0 29 20 17 41 13 48 8 4 36 6 16 26 32 22 26 44 39 9 11 24 48 29 26 16 30 3 6 18 7 
33 12 33 24 42 44 47 41 42 46 6 47 19 49 14 18 39 25 43 27 12 35 46 32 31 0 16 20 17 22 24 6 7 28 32 34 8 28 21 11 10 26 33 18 41 31 17 49 27 11 46 16 16 16 10 21 29 18 44 24 25 14 31 29 
34 30 26 7 42 21 14 45 11 8 7 4 40 2 4 43 29 26 48 39 28 41 25 19 28 27 4 46 43 48 7 0 40 36 10 18 49 44 40 25 11 7 37 0 41 28 15 20 7 44 37 49 39 30 19 18 44 45 10 41 10 2 10 19 
32 41 13 40 17 30 39 49 17 2 14 36 38 10 43 22 12 26 11 40 24 47 7 49 2 45 38 22 39 38 35 42 0 39 7 46 15 20 29 38 46 37 19 19 26 13 20 45 46 33 2 37 32 31 3 46 12 20 32 19 23 29 44 18 
47 49 20 27 5 32 5 49 30 36 8 42 41 15 22 2 31 39 2 49 38 36 47 25 35 5 38 9 33 13 30 35 43 14 20 39 8 5 28 3 10 10 11 28 32 35 26 5 7 22 45 21 39 19 20 43 47 29 19 15 39 18 32 33 
32 41 1 32 49 25 18 4 28 37 20 7 37 16 9 13 42 0 34 23 36 48 6 24 15 21 21 28 33 36 24 9 0 36 17 29 47 0 12 40 44 14 21 17 40 36 5 2 28 32 38 19 39 19 48 44 20 38 39 48 38 11 42 1 
43 42 33 15 20 18 22 17 14 10 40 42 14 38 10 18 21 35 19 29 42 32 38 45 24 12 14 27 1 24 10 17 13 23 3 17 8 1 16 6 19 20 4 37 42 28 27 34 37 3 39 33 30 10 28 30 12 4 18 45 15 11 49 26 
36 33 44 34 40 30 3 47 41 18 39 12 31 45 32 42 28 44 42 36 49 9 28 34 47 37 18 13 12 44 12 8 32 20 47 14 39 35 27 34 11 41 30 19 10 3 18 10 20 18 14 17 1 10 0 14 25 37 30 15 5 19 27 15 
5 26 34 42 12 42 19 48 5 23 48 5 36 38 7 4 35 0 37 8 30 25 44 46 32 49 2 47 34 8 14 40 20 32 6 17 16 41 42 15 41 4 23 15 32 49 49 3 7 31 34 12 49 30 24 5 1 3 38 6 21 4 33 39 
7 12 23 23 33 8 29 27 42 24 3 36 22 38 33 5 14 5 42 19 26 42 6 12 25 15 44 9 25 45 49 20 15 29 36 19 45 6 47 22 2 30 19 31 48 31 30 34 21 48 17 34 15 35 44 29 14 1 38 17 6 11 43 39 
28 18 4 10 47 33 1 47 40 36 46 38 7 12 20 45 0 10 3 28 31 29 0 12 14 43 45 47 38 20 5 5 23 42 48 24 34 43 26 6 2 28 15 11 32 35 17 14 26 34 2 32 33 14 22 11 15 40 36 25 38 0 25 29 
22 18 11 42 33 22 17 7 24 1 6 39 28 38 10 39 40 1 44 15 42 24 37 16 28 14 46 39 33 30 0 8 2 10 33 23 24 44 23 49 24 2 9 35 33 12 33 33 18 29 19 7 33 25 41 28 43 48 21 26 8 35 7 6 
18 15 0 23 32 21 10 36 41 35 19 34 38 43 1 2 37 44 0 36 37 41 48 0 7 7 17 8 18 47 42 29 24 42 46 33 29 28 39 45 3 20 31 27 36 12 48 40 42 29 33 39 29 37 3 14 46 18 9 29 7 7 11 35 
19 43 40 38 49 39 27 26 5 33 29 28 22 46 38 44 35 40 15 21 42 7 44 38 35 40 5 7 31 40 41 33 38 41 10 4 1 28 7 11 42 45 39 26 32 46 24 6 48 14 45 35 39 49 13 36 24 1 38 25 29 28 6 0 
45 10 21 38 21 31 14 16 22 19 45 48 23 28 6 22 19 2 1 14 32 10 46 4 25 18 41 10 7 48 4 5 8 41 24 27 47 12 11 49 29 37 41 30 5 45 29 22 0 8 4 32 42 13 1 23 26 16 0 11 21 47 14 38 
6 24 17 41 44 22 43 49 9 29 3 47 41 5 2 25 34 35 3 2 25 0 38 45 33 18 12 22 28 15 49 5 6 3 32 19 9 37 43 1 21 47 18 38 26 46 46 3 44 47 36 13 32 18 29 16 0 17 5 32 20 12 37 28 
2 15 22 32 5 31 8 23 40 0 7 45 22 46 10 42 10 32 35 13 13 7 49 3 13 40 1 0 32 49 42 49 9 32 24 7 7 4 4 5 41 45 4 10 9 26 17 39 44 44 35 47 45 44 43 33 30 41 27 28 34 3 35 5 
0 39 36 46 39 24 0 29 37 22 15 11 28 0 35 14 8 35 35 32 25 27 32 9 13 23 30 31 24 34 32 42 31 42 17 38 1 37 18 37 34 3 47 35 41 23 28 40 35 48 13 20 42 23 47 27 20 45 11 48 45 31 37 16 
45 26 27 42 36 36 30 28 46 43 5 22 20 33 14 45 25 49 5 30 26 7 41 34 49 29 16 35 3 48 11 26 48 8 27 36 10 1 17 8 37 32 18 35 2 30 21 5 20 25 16 49 9 13 40 41 32 17 31 27 8 48 39 12 
47 48 44 3 19 32 48 16 8 3 34 30 43 11 13 18 43 35 49 35 24 13 17 4 28 34 2 11 27 13 27 37 38 47 46 32 40 24 33 6 15 47 33 38 22 44 18 44 4 38 44 43 16 34 6 35 13 2 31 25 47 8 35 29 
46 2 46 47 43 38 22 10 43 20 24 42 27 36 23 30 30 1 48 0 32 39 41 32 46 26 36 14 38 44 12 38 43 46 14 9 31 32 6 35 48 27 48 10 39 45 46 30 21 12 6 48 39 28 29 5 2 37 4 25 20 9 47 49 
5 0 0 43 25 21 21 9 11 37 13 3 4 43 35 35 15 6 2 2 49 38 4 9 35 21 21 39 2 5 29 47 38 18 35 47 14 35 5 26 2 11 2 12 11 14 37 29 34 38 2 19 42 1 9 12 28 45 0 2 36 33 29 13 
4 27 34 0 24 8 9 48 21 40 47 17 39 11 45 6 46 39 49 21 45 24 25 3 48 5 22 7 26 47 26 42 11 11 26 41 35 3 46 45 38 29 32 45 15 34 29 35 45 14 8 45 34 17 4 2 3 47 41 47 3 6 22 13 
9 8 49 13 14 36 26 26 9 33 13 43 10 34 21 4 7 3 28 32 26 23 8 27 9 5 40 36 21 37 47 19 0 36 47 36 24 26 1 48 0 12 6 42 25 32 47 31 14 13 37 8 21 31 17 11 36 37 5 49 9 11 33 17 
38 35 7 15 16 46 39 42 27 21 13 41 19 11 22 8 45 49 11 44 42 35 26 20 40 10 0 42 23 15 12 14 11 42 36 3 7 49 47 42 10 17 49 36 33 15 27 46 46 10 31 13 31 31 13 26 3 12 11 8 10 37 14 36 
14 19 23 8 5 2 48 48 43 15 13 11 6 43 46 15 10 49 5 20 23 28 0 33 31 28 42 42 6 8 21 41 31 33 6 5 48 27 34 26 24 4 4 27 21 31 11 33 37 26 26 32 49 6 35 3 36 25 23 37 26 4 12 41 
41 31 11 41 17 19 20 8 7 48 42 33 23 39 23 47 5 6 7 47 10 23 20 37 42 16 33 30 19 1 39 41 8 8 7 0 31 20 12 26 6 28 33 12 38 23 8 13 31 22 0 21 16 23 43 6 22 36 21 43 4 39 38 34 
49 35 15 8 35 4 22 32 27 43 22 1 25 49 34 21 15 45 26 27 21 2 33 38 0 25 46 1 8 38 30 47 48 12 1 33 31 33 35 13 5 3 5 48 46 24 13 20 48 20 10 16 42 14 4 1 5 48 22 22 42 31 24 2 
33 4 27 2 20 11 19 49 8 7 39 46 26 40 31 30 15 3 10 25 6 29 8 1 17 2 31 9 5 4 28 45 16 40 4 7 15 29 9 8 7 21 31 1 33 37 40 17 16 27 22 29 19 14 8 14 27 30 28 43 26 25 24 12 
24 28 39 1 9 47 33 23 5 30 47 26 10 47 38 44 27 46 5 26 37 27 38 45 27 3 25 4 14 10 26 26 12 19 20 8 48 49 15 26 38 24 4 20 36 0 15 29 10 28 32 46 13 46 36 10 45 19 27 32 27 11 5 35 
10 9 42 31 33 12 32 5 31 47 14 27 6 41 35 8 15 25 45 20 42 24 20 47 21 25 11 21 20 3 36 25 48 43 20 1 12 1 30 13 35 6 26 25 17 38 32 23 26 33 5 16 15 22 42 17 44 34 5 35 21 32 5 25 
25 25 46 30 48 38 0 10 48 17 5 40 34 39 36 25 5 27 40 26 12 8 8 6 48 45 28 49 49 14 10 37 42 15 48 15 42 44 35 2 36 23 25 4 14 16 28 16 39 49 20 30 44 47 5 35 40 41 30 6 0 9 12 7 
47 24 11 43 13 31 47 8 37 6 46 30 4 5 12 34 9 8 3 5 11 49 43 20 46 30 19 39 11 11 6 32 24 20 24 37 8 15 8 36 9 5 45 25 1 2 16 38 45 49 9 4 25 10 34 37 5 41 48 16 18 13 46 36 
13 8 37 11 47 44 16 26 12 41 35 32 32 35 25 48 24 11 40 8 19 23 43 31 11 43 24 44 32 1 42 3 11 38 35 13 43 31 6 1 30 42 48 5 4 49 22 9 11 16 0 15 21 4 40 42 7 21 20 12 45 25 10 18 
48 37 23 31 38 10 11 1 36 23 40 7 16 26 29 25 18 23 15 14 9 16 11 22 37 32 40 12 18 19 45 9 23 44 41 48 39 47 27 10 39 27 24 49 43 42 48 26 24 2 31 8 32 42 19 7 49 13 4 39 10 33 46 26 
38 1 27 26 23 26 36 14 35 3 19 2 31 42 42 30 17 25 21 7 9 17 37 43 35 15 40 38 16 13 17 33 46 37 10 15 47 29 21 20 29 14 22 46 17 38 43 17 19 24 41 20 3 0 5 15 44 6 26 36 49 4 12 11 
1 47 9 38 27 3 38 32 3 19 3 39 17 12 17 22 18 30 8 30 17 1 45 27 32 33 10 39 48 42 18 14 25 22 0 9 16 28 41 0 34 38 26 33 23 4 33 5 20 13 47 5 4 15 20 39 22 49 23 37 22 19 17 42 
28 27 8 6 11 43 21 39 38 46 39 49 16 14 26 43 35 39 32 46 25 48 13 42 15 22 3 40 7 42 5 22 38 24 1 29 47 43 5 3 2 42 24 9 18 26 16 34 23 35 45 28 4 0 2 13 35 35 45 23 24 16 19 34 
27 48 12 45 34 49 29 23 20 11 47 25 31 46 23 38 4 16 17 10 22 43 45 36 13 35 38 6 1 9 36 18 23 25 10 29 16 18 33 21 0 32 1 32 12 17 24 14 14 10 39 20 29 12 31 14 36 15 26 17 39 0 32 21 
46 43 15 2 32 38 20 33 28 15 40 47 20 47 41 12 43 21 17 16 34 31 18 6 14 42 26 15 40 21 41 9 30 14 42 42 3 20 39 37 4 17 29 10 8 10 35 8 39 13 46 4 13 0 42 23 3 23 2 1 27 10 4 48 
33 46 1 4 6 24 26 23 32 27 9 4 9 26 38 24 38 3 9 29 1 33 28 31 19 21 6 14 46 11 46 21 19 0 22 34 40 20 37 44 42 48 46 10 12 33 10 15 44 8 6 13 32 46 11 10 10 4 18 36 42 3 1 30 
41 46 38 37 21 45 13 8 48 33 4 35 40 20 18 29 23 12 27 16 47 34 9 2 28 39 48 12 13 16 19 39 33 31 36 40 17 42 10 24 6 35 16 34 5 35 40 34 12 39 23 45 28 28 48 28 7 21 14 11 48 4 7 22 
8 30 30 21 21 39 0 16 48 42 11 41 12 0 45 29 49 22 35 3 36 18 12 38 34 17 1 19 0 3 21 0 26 42 39 46 2 19 38 48 16 45 34 7 21 25 0 6 29 21 31 7 14 1 20 38 28 10 6 33 24 5 29 42 
48 4 38 17 5 28 2 23 35 23 3 46 15 46 49 5 29 2 36 25 9 26 41 45 23 32 24 2 9 21 26 13 16 36 29 4 22 17 46 29 11 17 46 21 6 36 20 21 1 23 23 48 28 29 43 9 44 0 5 49 32 39 23 11 
38 33 9 31 12 30 30 30 39 34 34 21 35 29 5 46 34 33 8 19 10 31 10 38 45 17 13 8 4 39 46 23 26 16 32 24 4 22 6 36 33 20 6 44 12 29 17 24 45 32 39 26 14 35 7 22 42 2 9 17 18 17 37 24 
