64
64
37 12 31 0 30 34 44 5 22 14 27 12 3 5 11 8 0 33 4 36 32 16 24 36 48 36 8 38 42 30 46 1 0 39 15 48 32 21 31 49 5 44 2 18 46 2 2 39 17 4 27 14 46 34 9 38 21 17 8 27 29 0 13 44 
16 16 33 43 17 21 17 29 4 34 35 25 5 20 22 45 39 9 30 31 41 17 14 43 18 18 37 19 32 42 5 16 5 43 24 24 2 37 0 1 41 21 8 23 45 10 45 4 33 40 44 13 26 8 4 7 35 28 40 49 12 4 40 27 
34 10 22 5 4 3 41 31 0 18 42 1 0 40 23 46 47 35 38 20 30 16 33 48 29 1 4 17 28 25 35 21 31 39 10 48 17 27 28 11 17 29 0 36 6 49 17 21 2 10 25 1 20 41 49 32 21 40 21 16 21 28 39 19 
22 27 41 36 27 35 4 44 11 45 46 0 36 26 44 30 10 6 35 9 12 23 9 42 39 38 7 45 28 37 46 4 36 27 13 39 49 11 31 30 5 46 41 2 38 2 34 24 15 14 22 47 31 21 18 48 29 32 12 6 1 32 22 23 
15 13 14 21 43 24 31 23 17 5 20 39 28 46 21 7 17 42 22 17 9 43 14 43 33 10 48 48 17 18 35 30 2 8 13 36 9 22 29 26 47 30 29 39 37 30 36 21 1 44 14 12 29 11 45 23 37 3 7 42 12 25 48 29 
11 21 23 35 30 23 16 17 30 7 34 15 48 7 39 30 0 45 17 25 4 37 44 44 0 43 48 37 17 33 14 34 32 10 8 33 14 33 16 18 45 0 30 0 8 5 44 28 24 29 44 22 7 19 37 37 35 30 15 11 2 28 31 20 
35 11 33 11 38 32 37 32 38 32 42 49 28 30 37 12 27 18 47 38 43 25 42 40 26 27 43 7 10 22 39 32 38 23 15 23 18 31 48 33 38 31 10 35 28 36 8 19 10 29 6 22 2 4 32 31 10 21 15 8 40 13 49 37 
17 22 0 26 10 6 11 23 42 10 27 38 2 0 33 21 8 0 39 2 19 28 46 38 30 12 33 38 31 10 9 45 19 38 2 23 25 21 37 31 10 8 0 38 47 38 2 42 33 6 10 23 12 35 38 15 6 35 45 20 45 43 31 16 
34 47 28 42 5 36 38 43 19 10 21 14 41 32 42 0 26 3 43 42 36 7 46 5 31 15 2 45 4 34 21 32 9 22 33 48 44 31 14 23 49 42 8 31 30 34 36 41 32 44 39 17 44 14 44 45 33 17 47 9 5 23 37 11 
22 23 33 18 11 36 24 3 26 33 18 32 15 30 29 1 49 28 6 13 28 15 5 24 14 22 37 1 15 30 7 36 45 25 22 41 5 24 3 24 26 4 6 30 34 49 30 43 6 35 45 9 17 8 8 43 48 43 30 16 33 30 15 22 
33 39 41 25 22 49 9 42 8 30 20 1 16 29 14 34 49 26 7 9 49 15 45 49 19 24 18 16 26 29 37 46 34 24 35 34 14 45 8 47 14 16 11 15 6 32 11 14 5 39 32 10 16 12 36 49 49 30 26 18 46 33 21 30 
23 46 27 30 32 0 5 24 7 18 33 39 35 44 40 5 42 40 7 29 3 11 32 36 36 6 33 29 7 26 1 18 37 20 45 2 34 4 4 35 27 5 1 14 7 25 41 13 7 35 25 35 33 37 34 36 20 5 45 3 10 44 39 8 
40 46 23 42 40 38 7 20 6 25 22 45 4 23 48 13 16 36 12 28 29 38 44 35 13 0 24 11 1 1 42 6 24 42 42 2 7 40 5 28 37 22 28 45 33 12 4 27 33 12 22 31 48 3 30 18 7 39 2 12 49 16 26 36 
29 19 49 17 27 10 5 35 8 35 43 16 13 23 29 1 18 23 2 45 39 19 36 35 34 41 25 45 10 3 45 14 35 30 17 48 27 38 35 7 34 21 0 33 47 18 10 0 47 38 38 42 39 17 39 41 34 47 35 32 49 26 12 23 
0 41 40 30 23 24 13 23 7 48 30 41 18 41 25 28 38 12 15 31 33 28 20 40 43 6 1 41 40 7 0 11 46 9 0 19 24 17 14 9 41 7 19 26 44 25 6 41 47 26 0 14 34 18 11 28 5 41 20 10 46 38 19 2 
7 39 44 8 8 3 18 27 46 9 32 7 39 17 0 49 24 9 1 10 21 24 18 31 3 46 0 40 19 24 29 39 13 46 13 22 18 17 3 31 33 35 41 25 48 5 38 27 37 41 45 35 5 44 22 33 5 48 15 33 17 11 34 38 
45 31 37 19 15 22 22 24 6 36 41 14 26 32 16 18 7 43 30 23 6 44 8 15 46 46 9 17 9 23 11 5 16 49 38 16 26 11 18 22 28 29 47 41 0 48 8 37 2 26 49 18 47 1 2 16 7 5 38 7 32 48 7 33 
42 4 43 36 2 36 21 39 42 32 3 43 8 40 35 22 19 43 27 17 22 49 8 26 46 26 44 48 1 22 34 30 22 1 49 6 34 28 49 16 40 16 11 46 41 26 15 42 44 43 48 17 28 1 48 27 10 46 48 7 15 16 42 18 
46 29 14 4 23 41 25 19 47 34 10 9 15 3 17 30 10 38 42 15 5 0 45 35 10 33 32 39 4 30 4 10 3 39 43 36 46 32 5 41 28 17 1 45 18 10 9 40 37 17 44 25 14 13 18 40 26 12 39 46 34 28 21 28 
35 20 37 21 36 30 10 16 17 46 1 8 5 25 41 0 30 7 23 33 8 33 9 31 18 22 12 25 16 26 15 28 35 2 4 7 19 17 48 38 44 47 38 11 34 36 28 39 38 5 1 24 42 14 34 30 32 20 1 45 37 34 34 21 
21 20 30 38 44 22 11 41 31 15 12 25 23 24 33 30 23 6 13 10 32 5 5 12 38 11 3 22 32 11 30 3 31 43 10 6 31 14 16 37 46 43 6 34 45 7 30 10 17 24 22 7 6 26 41 29 38 7 39 20 5 35 12 32 
1 32 29 7 19 9 42 19 48 44 19 29 31 2 21 28 48 38 28 23 30 43 29 29 42 43 33 44 47 18 35 22 13 46 21 35 10 19 41 6 16 35 29 25 26 43 43 49 42 29 25 4 10 38 39 15 13 8 7 26 16 38 29 10 
25 33 15 10 33 41 39 16 10 46 4 43 11 20 26 6 21 20 0 30 5 15 42 6 42 21 20 36 37 45 42 12 29 20 14 20 6 12 33 43 15 46 30 37 38 37 27 9 35 24 42 23 44 13 18 1 29 33 5 34 34 1 27 0 
25 35 12 37 2 6 25 27 14 14 19 12 17 11 36 34 36 3 27 1 42 8 25 17 45 35 30 15 32 28 11 7 43 38 37 29 13 14 30 8 7 43 19 7 33 3 47 18 34 18 22 4 44 2 8 3 10 25 35 36 36 15 37 7 
9 15 46 28 38 48 42 21 43 16 41 10 48 17 43 21 20 38 26 2 31 23 27 22 47 28 47 28 25 10 40 32 32 0 26 32 10 39 13 48 2 5 15 42 36 45 14 8 23 6 3 37 47 5 49 7 0 45 25 1 30 19 15 3 
16 4 17 41 22 7 0 4 4 37 42 20 22 37 25 29 27 11 23 45 27 23 40 25 22 46 37 24 26 25 2 0 48 11 33 5 41 17 19 37 48 1 33 38 28 27 29 46 11 4 41 47 31 15 8 45 41 28 8 8 12 18 7 7 
26 46 43 6 28 18 11 39 44 48 38 27 31 34 16 36 29 28 32 44 44 5 31 32 41 35 47 20 41 14 9 27 39 6 20 25 10 20 33 26 5 45 22 38 44 22 6 43 43 49 6 20 42 19 23 3 12 31 16 22 0 3 1 32 
1 7 43 21 21 35 37 44 11 25 26 11 40 9 7 19 24 40 3 42 34 35 41 29 30 5 3 14 47 15 42 42 37 4 8 32 22 20 39 26 8 34 18 33 49 9 32 6 16 14 40 26 11 0 8 16 39 4 49 6 23 12 15 29 
20 13 5 37 11 43 33 25 40 31 46 23 11 34 42 0 12 33 46 45 20 22 31 20 25 6 29 26 46 8 13 38 6 18 45 6 45 35 24 23 11 27 13 40 49 47 15 22 46 36 21 16 0 18 10 2 46 33 35 17 23 20 34 9 
35 29 9 28 19 9 23 46 42 29 12 8 36 44 9 5 12 0 48 14 40 45 12 38 42 29 18 24 30 36 36 4 3 24 38 8 41 48 4 28 37 24 35 26 41 37 30 45 16 46 0 19 1 42 37 31 3 21 17 3 30 16 6 24 
36 28 6 41 14 27 25 1 13 26 42 45 27 10 33 26 26 45 7 40 10 3 29 49 20 40 22 47 43 18 19 47 4 49 33 28 40 8 12 30 38 2 46 23 8 35 29 40 18 30 44 26 8 3 49 32 49 12 1 12 26 38 21 2 
39 42 22 47 47 34 48 3 8 13 14 49 24 43 14 3 39 20 45 3 39 6 42 28 3 13 13 9 25 1 46 3 32 18 36 4 4 47 42 9 22 34 39 6 28 28 22 0 33 33 40 42 32 41 6 43 4 6 7 19 5 3 25 44 
22 2 13 30 16 35 38 28 12 42 19 38 19 44 42 27 37 20 11 12 17 3 3 10 15 35 35 45 5 42 6 29 13 15 13 36 32 12 10 28 39 42 10 6 10 29 5 24 37 40 18 6 49 0 34 40 34 33 2 12 12 26 21 12 
24 21 43 35 23 42 49 28 42 30 39 11 35 37 49 40 39 44 9 4 10 5 9 29 20 27 39 36 13 45 35 48 38 47 30 36 32 24 30 12 37 35 37 49 31 28 24 47 8 15 31 18 5 45 3 9 28 17 18 47 13 34 15 33 
25 6 10 5 14 30 27 4 47 16 32 31 21 41 10 49 4 7 37 5 16 36 44 42 18 10 21 34 49 5 39 10 34 49 32 31 8 10 0 8 13 0 21 40 26 4 16 3 16 45 48 31 26 20 10 4 38 17 13 48 35 49 33 7 
17 21 3 45 19 44 42 45 35 36 35 40 6 27 17 20 23 22 38 48 47 25 22 46 28 5 23 10 27 25 46 8 42 4 11 13 14 4 45 7 1 12 47 42 8 6 3 19 45 11 9 10 42 3 38 46 34 13 17 41 36 22 0 48 
1 7 0 33 6 29 7 24 45 15 22 13 26 27 4 8 49 7 9 18 42 35 43 27 8 28 46 5 14 40 13 25 30 29 9 24 15 49 31 21 45 42 47 29 5 47 21 10 16 8 3 41 38 39 8 47 18 24 12 45 27 6 30 11 
35 41 7 12 4 22 22 10 46 8 23 41 46 42 45 26 28 21 34 34 37 29 15 6 27 8 29 6 44 6 2 16 46 32 8 49 5 22 40 17 17 0 27 32 26 0 20 2 23 37 39 13 44 13 20 39 2 21 7 4 37 9 27 9 
7 22 25 27 23 43 29 38 46 20 23 19 16 45 6 5 45 5 10 31 2 30 35 3 41 14 44 14 39 44 47 30 38 48 9 4 4 8 2 36 14 11 15 22 30 19 25 38 38 4 47 15 8 6 31 27 5 20 38 17 31 33 1 17 
17 1 12 42 7 23 37 8 2 24 45 4 17 18 16 34 29 45 14 13 33 10 32 24 47 43 35 5 48 13 32 27 0 46 46 15 43 8 44 4 38 40 18 40 29 11 16 47 29 34 33 32 25 5 10 43 41 10 29 5 11 19 0 12 
9 0 30 41 39 21 32 16 11 48 31 20 37 8 49 43 24 32 44 47 17 12 27 31 42 26 40 16 37 21 15 8 10 28 49 26 42 38 2 6 39 44 33 45 20 37 7 6 33 40 44 12 13 28 49 15 4 40 9 46 17 47 45 0 
40 6 27 34 1 11 40 22 48 23 42 44 5 3 15 17 25 6 21 16 36 31 10 12 41 37 26 26 10 24 27 22 49 7 16 9 21 49 42 40 7 12 30 15 24 1 3 39 34 24 6 8 38 2 43 2 33 10 44 27 39 9 32 36 
34 32 21 32 11 44 17 37 22 6 19 41 30 25 15 15 25 39 2 17 32 11 4 35 15 25 12 39 23 22 36 21 21 44 15 43 46 16 48 14 38 2 47 31 30 28 8 7 40 15 17 49 4 22 31 39 1 25 38 9 9 36 5 19 
19 24 41 24 21 2 26 35 49 35 8 25 11 8 9 2 13 1 48 48 16 33 31 28 40 1 30 10 20 17 15 26 40 38 31 48 25 23 18 12 13 47 41 48 10 33 2 33 24 42 0 10 1 5 37 46 32 28 31 44 27 2 21 44 
16 37 41 16 8 29 49 19 30 29 44 11 6 18 7 34 0 16 25 26 9 2 1 19 46 45 46 26 38 47 22 24 25 44 32 42 13 31 29 37 26 30 8 3 3 19 25 19 7 2 25 28 34 12 45 46 4 24 37 19 26 15 2 23 
48 42 23 7 4 17 10 30 46 39 8 2 11 31 48 28 12 18 39 6 39 11 1 39 1 12 23 49 7 15 6 4 14 44 49 44 0 45 0 30 44 1 14 13 44 23 31 35 7 3 40 21 25 39 18 4 31 26 11 3 28 45 38 1 
1 13 22 34 21 15 39 16 9 44 21 27 14 4 11 21 15 13 16 24 44 47 5 32 42 17 17 16 33 39 6 23 39 23 16 18 36 38 41 4 13 33 37 8 16 37 48 18 26 12 15 36 39 14 36 16 4 24 49 5 39 6 39 15 
13 5 48 28 2 28 32 16 46 45 43 48 41 30 38 7 39 21 12 26 48 30 41 33 16 21 34 19 21 26 31 25 12 32 27 38 34 13 37 32 37 21 18 4 22 30 49 40 24 22 2 6 42 4 7 15 46 39 5 6 22 45 27 27 
2 21 5 39 11 11 38 19 10 36 29 8 32 43 12 25 41 13 13 10 44 43 32 11 45 33 36 24 37 27 37 30 18 36 48 17 38 48 23 3 12 47 35 4 48 47 49 29 40 21 46 9 9 43 22 6 25 22 46 40 15 48 21 7 
37 20 5 12 17 43 37 18 40 10 10 36 22 46 0 28 45 15 24 8 37 3 29 18 1 27 23 23 3 46 30 22 31 41 47 38 32 12 47 47 30 20 30 6 13 5 39 4 39 33 27 6 19 14 25 28 31 39 0 46 38 17 39 1 
43 1 6 36 17 43 17 32 5 22 25 9 34 36 2 31 26 42 43 14 5 14 30 3 33 19 24 26 35 22 18 20 39 24 35 15 46 18 7 44 36 7 2 29 10 10 19 36 49 25 43 26 21 1 24 18 19 37 45 31 29 37 15 29 
37 37 13 44 26 19 15 47 39 8 23 28 37 10 37 17 27 13 26 45 22 49 37 39 15 3 44 3 15 2 39 42 20 44 20 45 40 48 4 45 12 45 13 39 25 33 2 48 42 13 30 20 6 48 17 12 17 13 17 43 32 30 22 27 
16 44 26 3 41 3 19 12 1 23 19 13 19 18 8 12 24 6 38 31 39 1 6 12 11 8 26 39 49 12 43 43 8 33 22 47 21 15 44 0 2 13 1 2 13 11 14 45 3 35 21 35 8 26 20 13 29 42 32 1 4 14 18 30 
18 18 29 11 5 38 41 0 36 48 21 1 9 37 48 47 17 8 35 15 32 29 20 25 43 10 44 49 22 45 35 13 34 36 3 41 23 44 23 3 24 3 16 37 37 34 42 7 12 48 26 37 46 36 42 22 26 31 21 12 20 7 1 36 
32 3 13 34 30 30 37 35 26 34 19 14 35 4 31 35 16 44 3 6 3 22 24 10 25 8 23 9 15 10 41 31 14 32 10 48 32 38 1 39 29 14 12 43 10 23 38 31 11 20 39 47 43 35 23 47 28 24 18 15 21 21 13 2 
33 48 24 23 6 15 11 24 4 48 32 33 24 14 39 42 1 46 0 10 19 46 8 7 14 18 49 8 5 44 19 43 31 44 17 14 45 43 9 11 19 17 1 29 23 49 4 0 4 3 31 12 5 18 25 45 13 16 33 15 41 7 30 45 
21 33 32 16 42 24 8 6 45 40 18 46 16 32 42 31 46 11 27 12 20 8 34 0 8 21 39 39 0 42 8 49 29 37 12 25 30 32 49 13 44 11 16 10 9 33 26 5 40 49 26 6 9 21 18 3 27 4 5 20 15 45 47 15 
29 19 39 48 38 38 38 18 48 7 45 39 7 6 38 31 2 44 4 19 43 41 37 21 37 27 9 31 5 40 10 39 31 1 5 5 43 48 31 26 48 13 48 22 32 42 22 33 5 0 30 14 4 27 33 14 22 13 49 33 45 35 28 15 
34 41 25 15 24 29 3 12 2 42 35 22 37 13 15 39 33 42 1 33 7 45 21 18 30 14 18 24 43 9 5 13 8 27 32 3 28 19 0 21 33 43 36 34 0 5 1 20 15 47 31 25 29 47 14 33 33 19 46 23 35 8 27 46 
48 37 47 9 38 22 38 43 3 17 8 45 4 44 18 14 43 12 42 9 3 35 48 19 19 46 23 7 36 28 27 0 15 16 2 24 1 15 29 29 30 33 24 39 12 46 47 7 41 32 45 40 38 40 15 20 40 9 1 45 20 30 13 8 
45 16 33 7 47 28 13 28 28 19 47 5 19 25 21 20 21 24 23 0 7 24 42 38 0 43 35 33 15 6 39 40 42 22 15 43 27 3 45 20 39 44 21 48 44 19 46 25 25 27 0 29 41 39 17 22 35 28 17 31 32 9 6 22 
32 5 23 44 1 36 10 35 39 45 14 30 6 25 38 22 49 19 27 5 1 31 19 18 1 43 0 31 15 16 37 37 23 42 42 47 32 11 37 43 35 48 43 45 36 7 44 26 25 29 49 13 8 28 0 4 44 10 24 26 9 11 40 49 
3 1 44 11 26 0 39 32 35 12 47 8 31 3 12 19 25 18 24 25 9 41 10 43 21 19 46 40 10 46 5 10 10 41 15 38 44 17 0 33 18 22 45 17 38 4 2 29 15 1 35 19 29 42 32 46 20 45 29 23 30 34 19 38 
26 36 6 7 4 19 40 4 18 39 47 2 22 49 41 13 39 18 8 36 31 48 10 22 20 34 23 2 40 13 38 25 7 0 30 41 48 40 32 28 1 46 33 33 30 26 24 49 3 38 25 11 46 36 27 39 1 1 17 14 46 20 1 28 
